13 14 13 14 13 14 13 14 13 14 13 14 13 14 13 14 13 14 13 14 13 14 13 14 13 14 13 14 13 14 13 14
16 0 17 0 0 0 0 0 0 0 0 0 0 0 0 0 0 0 0 0 0 0 0 0 0 0 0 0 0 0 0 15
14 0 0 0 0 1 0 0 0 0 0 1 0 0 0 0 0 1 0 0 0 0 0 0 0 0 0 0 0 0 0 13
16 0 0 0 0 0 1 0 0 0 0 0 0 0 0 0 0 0 0 0 0 26 27 28 29 0 0 0 0 0 0 15
14 0 0 0 0 0 0 0 0 0 0 0 0 1 0 0 0 0 0 0 1 30 31 32 33 0 0 0 0 0 0 13
16 0 0 0 0 0 0 0 0 0 0 0 0 0 0 0 0 0 0 0 0 34 35 36 37 15 16 0 0 0 0 15
14 0 0 0 0 1 0 0 0 0 1 0 0 0 8 9 10 0 0 0 0 0 0 0 0 13 14 0 0 0 0 13
16 0 0 0 0 0 0 1 0 0 0 0 0 0 5 6 7 0 0 0 0 0 0 0 0 0 0 0 0 0 0 15
14 0 1 0 0 0 0 0 0 0 0 0 17 0 2 3 4 0 17 0 0 1 0 0 0 0 0 0 0 0 19 13
16 0 0 0 0 0 0 0 1 0 0 0 0 0 0 0 0 0 0 0 0 0 0 0 0 1 0 0 0 0 18 0
14 0 0 0 0 0 0 0 0 0 0 0 0 1 0 21 0 0 0 1 0 0 0 0 0 0 0 0 0 0 0 17
16 0 0 0 0 0 0 0 0 0 1 0 0 0 0 20 12 12 12 12 12 12 12 12 12 12 12 12 12 12 12 12
14 0 0 0 0 1 0 0 0 15 16 0 0 0 0 0 0 0 0 0 0 0 0 0 0 0 0 0 0 0 0 17
16 0 0 0 0 0 1 0 0 13 14 0 0 0 0 22 0 0 0 0 0 0 1 0 0 0 0 0 0 0 19 0
14 0 0 0 0 0 0 0 0 0 0 0 0 0 24 23 25 0 0 0 0 0 0 0 0 0 0 0 0 0 18 15
16 0 1 0 0 0 0 0 0 0 0 0 0 1 0 0 0 0 0 1 0 0 0 0 0 0 0 0 0 0 0 13
14 0 0 0 0 0 0 0 0 0 0 0 0 0 0 0 0 0 0 0 0 0 0 0 0 0 0 0 0 0 0 15
16 0 0 0 0 1 0 0 0 1 0 0 0 0 0 0 0 0 0 0 0 0 0 1 0 0 1 0 0 0 0 13
14 0 0 0 0 0 0 0 0 0 0 0 0 0 0 0 0 0 0 1 0 0 0 0 0 0 0 0 0 0 0 15
16 0 0 0 0 0 0 0 0 0 0 0 0 0 0 0 0 0 0 0 0 0 0 0 0 0 0 0 0 0 0 13
14 0 0 17 0 0 0 0 0 0 0 0 0 0 0 0 0 0 0 0 0 0 1 0 0 0 0 0 0 0 0 15
16 0 0 0 0 0 0 0 0 0 0 0 0 0 0 0 0 0 0 0 0 0 0 0 0 0 0 0 0 0 0 13
14 0 0 0 0 0 0 0 0 0 0 0 0 0 0 0 0 0 0 0 0 0 0 0 0 0 0 0 0 0 0 15
16 15 16 15 16 15 16 15 16 15 16 15 16 15 16 15 16 15 16 15 16 15 16 15 16 15 16 15 16 15 16 13
