14 13 14 13 14 13 14 13 14 13 14 13 14 13 14 13 14 13 14 13 14 13 14 13 14 13 14 13 14 13 14 13
16 0 0 0 0 0 0 0 0 0 41 42 43 0 0 0 0 0 0 0 15 16 15 16 0 0 0 0 0 0 0 15
14 17 0 0 0 0 0 41 42 43 0 0 0 0 17 0 41 42 43 0 13 14 13 14 0 0 0 0 0 0 0 13
16 0 0 0 0 0 0 0 0 0 0 0 0 0 0 0 0 0 0 0 0 0 0 15 16 0 0 0 0 0 0 15
14 0 0 0 15 16 0 0 0 0 0 0 0 0 15 16 0 0 0 0 0 1 0 13 14 0 0 0 0 0 0 13
16 0 0 0 13 14 0 0 0 0 0 0 0 0 13 14 0 0 0 0 44 0 19 0 0 0 0 0 0 0 0 15
14 0 0 15 16 0 0 0 0 0 0 0 46 0 15 16 0 0 0 0 0 0 18 15 16 15 16 0 0 0 0 13
16 0 0 13 14 0 0 0 0 0 0 0 0 0 13 14 0 0 0 0 0 0 0 13 14 13 14 0 0 0 0 15
14 0 19 0 0 0 0 0 0 15 16 15 16 15 16 0 0 0 41 43 0 0 0 0 0 0 0 0 0 0 0 13
16 0 18 0 0 0 0 0 0 13 14 13 14 13 14 0 0 0 0 0 0 0 0 0 0 0 0 0 0 17 0 15
14 0 0 15 16 0 0 0 15 16 0 0 0 0 0 0 0 0 0 0 0 15 16 0 0 0 0 47 0 17 0 13
16 0 0 13 14 1 0 0 13 14 0 0 0 0 0 0 0 0 0 0 0 13 14 15 16 0 0 0 0 0 0 15
14 15 16 0 0 0 0 0 0 0 0 0 0 41 42 43 0 0 0 15 16 0 0 13 14 41 42 43 41 42 43 13
16 13 14 0 0 0 0 0 0 0 0 0 0 0 0 0 45 0 0 13 14 0 0 0 0 0 0 0 0 0 17 15
14 17 0 0 0 0 0 0 0 0 0 0 0 0 0 0 0 0 0 0 0 0 0 0 0 0 0 0 0 0 17 13
16 17 0 46 0 15 16 15 16 0 0 0 0 0 15 16 15 16 15 16 0 0 0 0 0 0 0 0 0 19 0 15
14 19 0 0 0 13 14 13 14 0 0 0 0 0 13 14 13 14 13 14 17 0 0 0 0 0 0 0 0 18 0 13
16 18 41 42 43 0 0 0 0 0 0 0 0 19 0 0 0 0 0 0 15 16 0 0 0 15 16 0 0 0 0 15
14 0 0 0 0 0 0 0 15 16 0 0 0 18 1 0 1 48 0 0 13 14 1 0 0 13 14 0 0 0 0 13
16 0 17 0 0 44 0 0 13 14 0 0 15 16 0 0 0 0 44 0 15 16 0 0 0 0 0 0 45 0 0 15
14 0 17 19 0 0 0 0 0 1 0 0 13 14 0 17 0 0 0 0 13 14 0 0 0 0 0 0 0 0 0 13
16 0 0 18 0 0 0 0 0 0 0 0 19 0 47 0 0 19 0 0 0 0 0 0 0 19 0 0 0 0 0 15
14 0 0 0 0 0 0 0 0 21 0 0 18 0 0 0 0 18 1 0 0 0 0 0 0 18 0 0 0 0 17 13
15 16 15 16 15 16 15 16 17 39 17 15 16 15 16 15 16 15 16 15 16 15 16 15 16 15 16 15 16 15 16 15
