13 14 13 14 13 14 13 14 17 39 17 13 14 13 14 13 14 13 14 13 14 13 14 13 14 13 14 13 14 13 14 13
16 0 0 0 0 0 0 0 0 39 0 0 0 0 0 0 0 0 0 0 0 0 0 0 0 0 0 0 0 0 0 15
14 0 0 0 0 0 0 0 0 39 0 0 0 1 0 0 0 0 0 0 0 0 0 0 0 0 0 0 0 0 0 13 
16 0 0 17 0 17 0 0 0 39 0 0 0 0 0 0 1 0 0 15 16 0 0 0 0 0 0 0 0 0 0 15 
14 0 0 17 1 17 19 0 0 39 0 0 19 0 0 0 0 0 0 13 14 0 0 0 0 0 0 0 0 0 0 13 
16 1 0 17 0 17 18 0 0 39 0 0 18 0 0 0 0 0 0 0 0 0 0 0 0 0 0 0 0 0 0 15 
14 0 0 17 0 17 0 1 0 39 0 0 0 0 0 1 0 0 0 0 0 0 0 0 0 1 0 0 0 0 0 13 
16 0 0 0 0 0 0 0 0 39 0 15 16 0 0 0 0 0 0 0 0 0 0 0 0 0 0 0 0 0 0 15 
14 0 0 0 0 1 0 0 0 39 0 13 14 0 0 0 0 0 0 1 0 0 0 0 0 0 0 0 0 0 0 13 
17 0 0 1 0 0 0 0 0 39 0 0 1 0 0 0 0 0 0 0 0 0 0 0 0 0 0 0 1 0 0 15 
12 12 12 12 12 12 12 12 12 38 12 12 12 12 12 12 12 12 12 12 12 12 12 12 12 12 12 12 40 0 0 13 
17 0 0 0 0 1 0 0 0 0 0 0 0 0 0 0 0 0 0 0 0 1 0 0 0 0 0 0 39 0 0 15 
16 0 0 0 0 0 0 0 17 17 17 0 0 0 0 0 0 0 0 0 0 0 0 0 0 0 19 0 39 0 0 13 
14 0 0 0 0 0 0 0 0 0 0 0 0 0 1 0 0 0 0 1 0 0 0 0 0 0 18 0 39 0 0 15 
16 0 0 0 0 0 0 0 0 0 0 0 0 0 0 0 0 0 0 0 0 0 0 0 0 0 0 0 39 1 0 13 
14 0 0 0 0 0 0 0 0 0 0 0 0 0 0 0 0 0 0 0 0 0 0 15 16 0 0 0 39 0 0 15 
16 0 0 0 0 0 0 0 0 0 0 1 0 0 0 0 0 0 0 0 0 0 0 13 14 1 0 0 39 0 0 13 
14 0 0 0 0 0 0 0 0 0 0 0 0 0 0 0 0 0 0 0 0 0 0 0 0 0 0 0 39 0 0 15 
16 0 0 0 0 0 0 0 0 0 0 0 0 0 0 0 0 0 0 0 0 0 0 0 0 0 0 0 39 0 0 13 
14 0 0 0 0 0 0 0 0 0 0 0 0 0 0 0 0 0 0 0 0 0 0 0 0 0 19 0 39 0 0 15 
16 0 0 0 0 0 0 0 0 0 0 0 0 0 0 0 0 0 0 0 0 0 0 0 0 0 18 0 39 0 0 13 
14 0 0 0 0 0 0 0 0 0 0 0 0 0 0 0 0 0 0 0 0 0 0 0 0 0 0 0 39 0 0 15 
15 16 0 0 0 0 0 0 0 0 0 0 0 0 0 0 0 0 0 0 0 0 0 0 0 0 0 0 39 0 0 13 
13 14 15 16 15 16 15 16 15 16 15 16 15 16 15 16 15 16 15 16 15 16 15 16 15 16 15 16 39 15 16 15